NO ./texture/walls/Neon1
SO ./texture/walls/Neon2
WE ./texture/walls/Neon3
EA ./texture/walls/Neon4

F 29,17,40
C 29,26,31

        1111111111111111111111111
        1000000000110000000000001
        1011000001110000000000001
111111111011000001110000000000001
100000000011000001111110111111111
11110111111111011100000010001
11110111111111011101010010001
11000000110101011100010010001
10000000000000001100000010001
10000000000000000001010010001
11000001110101011111000000N0111
11111111 1111111 111111111111
