NO ./texture/walls/Neon1
SO ./texture/walls/Neon2
WE ./texture/walls/Neon3
EA ./texture/walls/Neon4

F 29,17,40
C 29,26,31

        1111111111111111111111111
        10000000001100000000000A1
        1A110000011100000000000A1
1111111110110000011100000000000A1
10000000001100000111111D111111111
11110111111111011100000010A01
1111D111111111011101010010001
11000000110101011100010010001
10000000000000001100000010001
10000000A00000000D01010010001
1100000111010101111100000E00111
11111111 1111111 111111111111
