NO ./texture/walls/wall_mn.xpm
SO ./texture/walls/wall_ms.xpm
WE ./texture/walls/wall_sw.xpm
EA ./texture/walls/wall_me.xpm

F 136,45,23
C 119,181,254



1111111111111111111111111111111111111111111111
1000000011001111111100000000000100000010000001
1000000011000000101100011000010000000010111101
1000000011001110000000000001111100000000110001
1110111111111111111111101111111100000011110001
1110111111100011111100000001111111111111110001
1110111111110111110100000001111111100000111101
1110111111000000010100000000000000000000111101
1110111111000000010100000000000001100000111101
1110111111000000010100000001111101100000111101
11101100000111110101000N0001111000111111111101
1110000100011111000000000001111000000000000001
1111111111111111111111111111111111111111111111
