NO ./texture/walls/wall_mn.xpm
SO ./texture/walls/wall_ms.xpm
WE ./texture/walls/wall_sw.xpm
EA ./texture/walls/wall_me.xpm

F 136,45,23
C 119,181,254



1111111111111111111111111111111111111111111111
1AAAAAAA11A011111111000000000D0100000010000001
1000000011A00000101100011000010000000A101111D1
1000000011A01110000D000000011111A00000D0110001
111D1111111111111111111D1111111100000A11110001
111011111110A011111100000001111111111111110001
111011111111D11111A100000001111111100000111101
1110111111000000010100000000000000D00000111101
11101111110000000101000000000000011000001111A1
11101111110000000101000000011111D1100000111101
1110110D00011111D1D1000E0001111000111111111101
1110000100011111000000000001111000000000000001
1111111111111111111111111111111111111111111111
