NO ./texture/walls/wall_ln.xpm
SO ./texture/walls/wall_ls.xpm
WE ./texture/walls/wall_lw.xpm
EA ./texture/walls/wall_le.xpm

F 0,0,0
C 255,255,255

        1111111111111111111111111111111111111111111111111111
        10000000001100000000000000000000000000000000000000001
        10110000011100000000001000000011111111001011111100001
        10010000000000000000001000000000000001001000000000001
1111111110110000011100000000000000000000000000000000000000001
100000000011000001111011101111111111111111111111111111111111
11110111111111011100000010001
11110111111111011101010010001
11000000110101011100000010001
10000000000000001100000000001
10000000000000001101010010001
1100000111010101111101110000111
11110111111101011101111010001
10000000000000000000000000001
10000000000000000000000000001
1000000000000S000000000000001
10000000000000000000000000001
10000000000000000000000000001
10000000000000000000000000001
10000000000000000000000000001
10000000111110111110000000001
10000000010000000100000000001
10000000001000001000000000001
10000000000100010000000000001
10000000000010100000000000001
10000000000001000000000000001
11111111111111111111111111111